XXXXXXXXXXX
X.........X
X.XXXX.XXXX
X.X......XX
X.X.XXXX.XX
X.X.X..X.XX
X.X.X.XX.XX
X...X....XX
X.XXXXXX.XX
X........XX
XXXXXXXX..X
XXXXXXXXXXX
start 1, 1
end 6, 5
